9 8 23
1 6
2   2   2   2   2   2   2   2   2
2   2   2   2   2   1   11   2   2
2   2   1   1   12  1   1   2   2
2   2   1   12  1   12  2   2   2
2   1   1   2   2   2   2   2   2
2   1   13  1   1   13  1   2   2
2   1   13  1   13  1   1   3   2
2   2   2   2   2   2   2   2   2
0