9 8 23
2   2   2   2   2   2   2   2   2
2   2   2   2   2   1   8   2   2
2   2   1   1   9   1   1   2   2
2   2   1   9   1   9   2   2   2
2   1   1   2   2   2   2   2   2
2   1   10  1   1   10  1   2   2
2   1   10  1   10  1   1   3   2
2   2   2   2   2   2   2   2   2