9 8 24
5 1
2   2   2   2   2   2   2   2   2
2   2   1   1   1   1   2   2   2
2   2   12  2   1   1   1   1   2
2   1   1   2   2   13  13  13  2
2   1   1   2   2   1   1   1   2
2   11  1   2   2   1   12  1   2
2   2   2   2   2   3   1   12  2
1
1   1   1   1   1   1   1   1   1
1   1   1   1   1   1   1   1   1
1   1   1   1   4   4   1   1   1
1   1   4   1   1   4   4   1   1
1   1   1   1   1   1   4   1   1
1   1   1   1   1   1   1   1   1
1   1   1   1   1   14  1   1   1
1   1   1   1   1   14  14  1   1