10 7 23
2   2   2   2   2   2   2   2   2   2
2   11  2   1   1   13  2   2   2   2
2   1   13  1   13  1   6   1   2   2
2   13  1   13  1   13  13  1   3   2
2   1   13  1   13  1   13  13  1   2
2   2   1   13  1   13  1   2   2   2
2   2   2   2   2   2   2   2   2   2
1
1   1   1   1   1   1   1   1   1   1
1   1   1   5   1   1   1   1   1   1
1   1   1   4   4   1   1   1   1   1
1   1   1   1   1   1   1   1   1   1
1   1   1   1   1   1   1   1   1   1
1   1   1   1   1   1   1   1   1   1
1   1   1   1   1   1   1   1   1   1