8 9 23
3 1
2   2   2   2   2   2   2   2
2   2   2   2   1   3   2   2
2   2   2   1   6   13  1   2
2   11  2   1   1   13  1   2
2   1   2   1   1   1   1   2
2   12  2   13  13  13  13  2
2   1   1   1   1   1   1   2
2   2   2   2   2   2   1   2
2   2   2   2   2   2   2   2
1
1   1   1   1   1   1   1   1
1   1   1   1   1   1   1   1
1   1   1   1   1   1   1   1
1   1   1   9   1   1   1   1
1   1   1   1   9   1   9   1
1   1   1   1   1   1   1   1
1   9   1   9   1   1   9   1
1   1   1   1   1   1   1   5
1   1   1   1   1   1   1   1