11 8 33
6 2
2   2   2   2   2   3   2   2   2   2   2
2   2   2   2   1   1   1   2   2   2   2
2   2   2   2   13  6   13  2   2   2   2
2   2   13  2   13  1   1   2   1   2   2
2   13  1   1   13  13  13  1   1   1   2
2   1   13  13  13  1   1   13  13  1   2
2   2   11  1   13  1   1   13  1   2   2
2   2   2   2   2   2   2   2   2   2   2
1
1   1   1   1   1   1   1   1   1   1   1
1   1   1   1   1   1   1   1   1   1   1
1   1   1   1   1   1   1   1   1   1   1
1   1   1   1   1   1   1   1   1   1   1
1   1   1   1   1   1   1   1   1   5   1
1   1   1   1   1   1   1   1   1   1   1
1   1   1   1   1   1   1   1   1   1   1
1   1   1   1   1   1   1   1   1   1   1