9 8 23
6 1
2   2   2   2   2   2   2   2   2
2   2   2   2   2   1   1   2   2
2   2   1   1   12  1   1   2   2
2   2   1   12  1   12  2   2   2
2   1   1   2   2   2   2   2   2
2   1   13  1   1   13  1   2   2
2   1   13  1   13  1   1   3   2
2   2   2   2   2   2   2   2   2
1
1   1   1   1   1   1   1   1   1
1   1   1   1   1   1   1   1   1
1   1   1   1   1   1   1   1   1
1   1   1   1   1   1   1   1   1
1   1   1   1   1   1   1   1   1
1   1   1   1   1   1   1   1   1
1   1   1   1   1   1   14  14  1
1   1   1   1   1   1   1   1   1