10 9 32
3 8
2   2   2   2   2   2   2   2   2   2
2   2   2   2   3   3   3   1   2   2
2   2   2   2   2   2   2   6   2   2
2   2   2   1   1   1   1   1   1   2
2   2   2   1   2   1   2   1   1   2
2   2   2   1   1   12  1   1   2   2
2   1   2   1   2   1   2   1   2   2
2   1   1   1   1   1   12  1   2   2
2   2   2   2   2   2   2   2   2   2
1
1   1   1   1   1   1   1   1   1   1
1   1   1   1   14  14  14  14  1   1
1   1   1   1   1   1   1   1   1   1
1   1   1   1   4   4   1   1   1   1
1   1   1   4   1   4   1   1   1   1
1   1   1   1   1   1   4   4   1   1
1   5   1   4   1   4   1   1   1   1
1   1   1   1   1   1   1   1   1   1
1   1   1   1   1   1   1   1   1   1