9 10 43
3 1
2   2   2   2   2   2   2   2   2
2   2   1   1   1   2   2   2   2
2   2   13  13  13  2   2   2   2
2   1   1   1   1   2   2   2   2
2   2   1   13  1   1   2   2   2
2   2   12  2   13  13  1   1   2
2   2   1   1   13  1   12  2   2
2   2   2   2   2   6   13  1   2
2   2   2   2   2   1   3   2   2
2   2   2   2   2   2   2   2   2
1
1   1   1   1   1   1   1   1   1
1   1   1   1   1   1   1   1   1
1   1   1   1   1   1   1   1   1
1   1   1   1   5   1   1   1   1
1   1   9   9   1   1   1   1   1
1   1   1   1   1   1   1   1   1
1   1   1   1   1   1   1   1   1
1   1   1   1   1   1   14  1   1
1   1   1   1   1   14  14  1   1
1   1   1   1   1   1   1   1   1