8 9 32
6 5
2   2   2   2   2   2   2   2
2   2   2   2   3   1   2   2
2   2   2   2   1   6   1   2
2   1   1   2   13  13  13  2
2   12  13  1   12  13  1   2
2   1   2   12  1   1   1  2
2   1   2   2   1   2   2   2
2   1   1   1   1   2   2   2
2   2   2   2   2   2   2   2

1   1   1   1   1   1   1   1
1   1   1   1   14  14  1   1
1   1   1   1   14  1   1   1
1   1   5   1   1   1   1   1
1   1   1   1   1   1   1   1
1   1   1   1   1   1   1   1
1   8   1   1   9   1   1   1
1   9   8   9   8   1   1   1
1   1   1   1   1   1   1   1